SO textures/cobblestone_mossy.xpm
NO textures/glass_silver.xpm

WE textures/hardened_clay_stained_gray.xpm
EA textures/hardened_clay_stained_green.xpm
C 51,51,51
F 99,00,00

111111111111111111111111111111111
100000001000000000110000000000001
100111101011000001110000000000001
100111101001001000000000000000001
111111101011000001110000000000001
100000000011000001110111111111111
11110111111111011100000010001
11110111111111011101010010001111111111111
110000001101010111000000000000000000000W1
10000000000000001100000010001111111111111
10000000000000001101010010001
11000001110101011111011110001
11110111 1110101 111111110001
11111111 1111111 111111111111
