SO textures/south1.xpm
NO textures/south1.xpm
WE textures/south1.xpm
EA textures/south1.xpm
C 177,174,177

F 50,47,49


111111        
1S0001        
100001 1111111
100001 1000001
100001 1000001
10000111000001
10000030000001
11111111111311
          1011
          1001
11111111111131
10000000000001
10000000000001
11111131111111
11111101111111    
11111100000111    
11111111110001    
11111111111101111111111111111111
11111111111100000030000000000111 
11111111111111111111111111000111
1111111111111            1000111
1111111111111            1000111
11111111111111111111111111000111
10000000000003000050000003000111
10011111111111111111111111111111
1001
1001111111111111111111111111111111111111111111111111111111111
1001003003003003001003001003001000003003001000000500000000001
1001001001001001001311001111001111111001111111001111111001001
1000001001001001003001001001001000001003000001000000001001001
1001111111111111001001001001001111131111111001001111111001001
1003000001000000001001003001001003000001000000000001000001001
1001111111111111111001111001001111001111111001111111111111001
1001000001003001000001003000003003000000003003001001001000001
1111001111111001111111111111111001111001111111001001001111001
1001000000001001000001001000000001001000001003005003001000001
1001111111001001111001001111001111001111001111001111111111001
1000000003001003000005000003000001001003001001001000003001001
1111001111111111131111111111001111001001111001111111111001111
1000000001001003000000000001001000001000001003003000003000001
1001001111001001111111111111111001111111111111001111111111001
1001000003000003001003001000000000001003001003001001001000001
1111111111001111111001111001111001001111001001001001001111111
1001001003003000001001001000001001001001000001001000001000001
1001001111111111001001001001111111111001111111001311001111001
1000000001003003003001003003003500003001001001000001001000001
1001111001001001111001001111001111001111001001001111111111001
1000001000001001001001001001003001003005003001001000000000001
1111001111111001001111001001001111001111111001001111001111001
1000000001000003001001000001003001003001000003000000000001001
1001111111001001111001111111001111111001001111111001001111001
1003000001001001001003001001005001000001001000001001000001001
1001111111001001001001001001111001111001111111001001111111111
1001000050001003003001003001001001000001000000003001000001001
1111001111111111001111001111001001001001111111111001001001001
1000003000001001001001000001003001001003001001001003001000001
1111111111111001111001001111001111111111001001001111111001111
1000000001001003000003001003000000001001001000001003003001001
1001001111001001111111001001111001001001111001001111001111001
1001003000003001003001000001000001000001000001001001003000001
1111001001111001001001111001111111111131111001001001001111111
1003001005001001001000001000001000000000003001000001003001001
1001111111001111111001131111001111111111111111111111001111001
1001001003001000003001000001001000000000000001000003003050001
1001001001001111001001111111001311111111111111111001001111131
1000001001001000001003000000000030000001000000503001001000001
1111111111111111111111111111111111111111111111111111111000001
                                                      1000001
                                                      1000001
                                                      1000001
                                                      1116111
                                                        111
