SO textures/south1.xpm
NO textures/south1.xpm
WE textures/south1.xpm
EA textures/south1.xpm
C 177,174,177
F 50,47,49


111111        
1S0001        
100001 1111111
100001 1000001
100001 1000001
10000111000001
10000030000001
11111111111311
          1011
          1001
11111111111131
10000000000001
10000000000001
11111131111111
11111101111111    
11111100000111    
11111111110001    
11111111111101111111111111111111
11111111111100000030000000000111 
11111111111111111111111111000111
1111111111111            1000111
1111111111111            1000111
11111111111111111111111111000111
10000000000003000055000003000111
10011111111111111111111111111111
1001
1001111111111111111111111111111111111111111111111111111111111
1001000000000000001000001000001000000000001000000500000000001
1001001001001001001311001111001111111001111111001111111001001
1000001001001001000001001001001000001000000001000000001001001
1001111111111111001001001001001111131111111001001111111001001
1003000001000000001001000001001000000001000000000001000001001
1001111111111111111001111001001111001111111001111111111111001
1001000001000001000001000000000000000000000000001001001000001
1111001111111001111111111111111001111001111111001001001111001
1001000000001001000001001000000001001000001000000000001000001
1001111111001001111001001111001111001111001111001111111111001
1000000000001000000005000000000001001000001001001000000001001
1111001111111111131111111111001111001001111001111111111001111
1000000001001000000000000001001000001000001000000000000000001
1001001111001001111111111111111001111111111111001111111111001
1001000000000000001000001000000000001000001003001001001000001
1111111111001111111001111001111001001111001001001001001111111
1001001000000000001001001000001001001001000001001000001000001
1001001111111111001001001001111111111001111111001311001111001
1000000001000000000001000000000500000001001001000001001000001
1001111001001001111001001111001111001111001001001111111111001
1000001000001001001001001001000001000005000001001000000000001
1111001111111001001111001001001111001111111001001111001111001
1000000001000000001001000001000001000001000000000000000001001
1001111111001001111001111111001111111001001111111001001111001
1000000001001001001000001001050001000001001000001001000001001
1001111111001001001001001001111001111001111111001001111111111
1001000000001000000001000001001001000001000000000001000001001
1111001111111111001111001111001001001001111111111001001001001
1000000000001001001001000001000001001000001001001000001000001
1111111111111001111001001111001111111111001001001111111001111
1000000001001000000003001000000000001001001000001000000001001
1001001111001001111111001001111001001001111001001111001111001
1001000000000001000001000001000001000001000001001001000000001
1111001001111001001001111001111111111131111001001001001111111
1003001000001001001000001000001000000000000001000001000001001
1001111111001111111001131111001111111111111111111111001111001
1001001000001000003001000001001000000000000001000000000050001
1001001001001111001001111111001311111111111111111001001111131
1000001001001000001000000000000030000001000000503001001000001
1111111111111111111111111111111111111111111111111111111000001
                                                      1000001
                                                      1000001
                                                      1000001
                                                      1116111
                                                        111


