SO textures/south1.xpm
NO textures/south1.xpm
WE textures/south1.xpm
EA textures/south1.xpm
C 177,174,177
F 50,47,49


111111        
1S0001        
100001 1111111
100001 1000001
100001 1000001
10000111000001
10000030000001
11111111111311
          1011
          1001
11111111111131
10000000000001
10000000000001
11111133111111
110011001111011111
100111000001000001
101111011100010111
10001100001101011111111111111111
10111110100111000030000000000111 
10000000101111111111111111000111
1011111110001            1000111
1000000111111            1000111
11011111111111111111111111000111
11111111100003000055000003000111
11111111111111111111111111111111
