SO textures/south.xpm
NO textures/north.xpm
WE textures/west.xpm
EA textures/east.xpm
C 51,51,51
F 112,112,100

11111111111111111111111111111111111111111
10000000100000000011000000000000000000011111
100111101011000001110000030000000000000000111111
100111101001001000000000000000000000000000000001111
11111110101100000111000000000000111111111000000000111
100000000011000001110111111111111     11111100000000011
11110111111111011100000010001              1111000000011
11110111111111011101010010001111111111111     11111113111
110000001101010111000000000000000000010W1       1100000011
10000000000000001100000010001111111111001        1111011111
10000000000000001101010010001010101010001111111111000000001
11000001110101011111011110000000000000000000300000000000001
11000111 1000101 111111111111111111111011111111111100000001
11100011 1110011                     101        11000000111
1111000111111001111111111111111111   101       11000000111
1000000000000001000000300000000001   101    111000000111
1010101000111111100011110000000001   10111110000000111
10111111110000000000111000000000011111001000000000111
101000000000000000001111000000000110000000000000111
1000100000000000000011100000000000000000000011111
1111000001111111111011111000000000001111111111
1000000001000000111110000000000100011111111
100001110110101110000000000000110111111
100001 100100010000000000000011101
1111111110110110000000000001111001
1110000000000000000000000111110001
1100001111000000000001111111100001
1100000111100000111111111000000001              1111111
1110000011110001111111110000000001     1111   11000000111
111100000111100000111110000000000111111100111110001111
110000000011111100000000000011111110000000000000001
11100000000111111111100011111000000001111100000000111111
11110000000011111111111111000000111111   1000000000111111
11100000000001111100000000000011111    1100001111001
1111110011000000000000011001111111     1000001  10011111
1100000001000000111100011000011111     1000011   10000001
1110000011000001100000011100000111     1000111  1000110001
1101100010000111000000011100000011     1000111  1100110011
1100000000000110000000011100011111     1100011    101 11
1110000011000000000000011101111111     1111111     11  1
111111111111111111111111111111111
