SO textures/south.xpm
NO textures/north.xpm
WE textures/west.xpm
EA textures/east.xpm
C 51,51,51
F 112,112,100

1111111
111S111
1000001
1000001
1000001
1001111111111111
1000000001000001
1001111111001001
1001000000001001
1001001111111001
1001001000000001
1001111111001001
1000000001001001
1001111001001001
1001000000001001
1111111111111001
        10000001
        10000001
        10000001
        11166111
        11111111
